   #######
###   .   ###
#   $       #
#           #
###       ###
  #   @   #
  #########  