  ###########
 ######.######
#      $      #
#  .  $@$  .  #
#      $      #
 ######.######
  ###########