##########
####  .###
###.  ####
####$ . ##
##.$.$$ ##
# $ *@####
# # $ $.##
#   .#####
##########
##########